00000000000000000000
01111111111111111110
01111111111111111110
01111111011111111110
01111111111111111110
01111111011111111110
01111111000000111110
01111111111111111110
01111111011111111110
01111111111111111110
01111111111111111110
01111111111111111110
00000000000000000000
01111111111111111110
01111111111111111110
01111111111101111110
01011010110111111110
01111111111111111110
01111111111111111110
00000000000000000000
